3311111111111-
1311111111111-
1311111111111-
1311111111111-
1111111111111-
1111111111111-
1111111111111-