00100010000111-
10101010110111-
10101010110111-
10101010110111-
10101010110111-
10101010110111-
10001000110011-
11111111111111
