06150615006111-
12121212112111-
12121212112111-
12121212112111-
12121212112111-
12121212112111-
13041304113011-
11111111111111
